111111111111111111111
101000000100010000011
100P010000000C0010E01
111111111111111111111
